11 10
4 6
XXXXXXXXXX
X.X.X....X
X...X.XX.X
X.X.X..X.X
X.X..X.X.X
X.XX.XXX.X
X..X.....X
XX.XXXXXXX
X.......tX
XXXXX.X..X
XXXXXXXXXX